Professor Charles Xavier (Professor X) - Telepatia
Scott Summers (Ciclope) - Raios ópticos de energia
Jean Grey (Fênix / Marvel Girl) - Telepatia e telecinese
Logan (Wolverine) - Fator de cura e garras retráteis de adamantium
Ororo Munroe (Tempestade) - Controle do clima
Kurt Wagner (Noturno) - Teletransporte e agilidade sobrenatural
Anna Marie (Vampira) - Absorção de poderes e memórias através do toque
Hank McCoy (Fera) - Força e agilidade aprimoradas, além de inteligência sobre-humana
Bobby Drake (Homem de Gelo) - Manipulação do gelo
Emma Frost - Transformação em diamante e telepatia
James "Logan" Howlett (Daken / Wolverine) - Fator de cura e garras retráteis de osso
Laura Kinney (X-23 / Wolverine) - Fator de cura e garras retráteis de adamantium (clonada de Wolverine)
Warren Worthington III (Anjo) - Asas e capacidade de voar
Piotr Rasputin (Colossus) - Transformação em aço orgânico
Remy LeBeau (Gambit) - Carga cinética e habilidade com cartas de jogar
Kitty Pryde (Lince Negra / Shadowcat) - Intangibilidade e habilidades de phasing
Rachel Summers (Fênix / Marvel Girl) - Telepatia, telecinese e habilidades fênix
Cable (Nathan Summers) - Telepatia e tecnopatia, além de habilidades fisiológicas avançadas
Bishop - Capacidade de absorver e redirecionar energia
Psylocke (Elizabeth Braddock) - Telepatia, telecinese e habilidades psíquicas
Jubilation Lee (Jubileu) - Emissão de fogos de artifício energéticos
Danielle Moonstar (Miragem) - Manifestação de ilusões baseadas em emoções
Lucas Bishop (Bishop) - Absorção e redirecionamento de energia
Betsy Braddock (Capitã Britânia / Psylocke) - Força sobre-humana e habilidades psíquicas
Quentin Quire (Kid Ômega) - Manipulação da realidade e telepatia
Monet St. Croix (M / Monet) - Força, velocidade e sentidos aprimorados
David Haller (Legião) - Várias personalidades e poderes variados
Jamie Madrox (Homem Múltiplo) - Capacidade de se clonar
Illyana Rasputin (Magia) - Magia e teleportação através de Limbo
Laura Kinney (X-23 / Wolverine) - Fator de cura e garras retráteis de adamantium (clonada de Wolverine)
Nate Grey (X-Man) - Telepatia e telecinese
Polaris (Lorna Dane) - Controle magnético
Apocalipse 
